1234567890.,-_ '`!?:;­´"()「」。、[]<>{}/\*«»‘’‚‛“”„‟…=
AÀÁÃÄÅÆĂĄǠǢǍǞǺǼȀȂȦàáãäåæăąǡǣǎǟǻǽȁȃȧ=a
ÂĀâ=ā
BƀƁƂƃƄƅ=b
CÇĆĈĊČƆƇçćĉċčƈ=c
DĎĐƉƊƋďđƌƍ=d
EÈÉËĔĖĘĚƎƏƐȄȆȨèéëĕėęěȅȇȩ=e
ÊĒê=ē
FƑƒ=f
GĜĞĠĢƓǤǦǴĝğġģǥǧǵ=g
HĤĦǶȞĥħƕǷȟ=h
IÌÍÏĨĬȊĮİĲƖȈìíïĩĭįıĳƗȉȋ=i
ĪÎî=ī
JĴĵ=j
KkĶƘǨķĸƙǩ=k
LĹĻĽĿŁĺļľŀłƛƚ=l
MƜµ=m
NÑŃŅŇŊƝñńņňŉŋƞ=n
OÒÓÕÖØŎŐŒƟƠƢǑǪǬǾȌȎȪȬȮȰòóõöøŏőœơƣǒǫǭǿȍȏȫȭȯȱ=o
ÔŌô=ō
PƤƥ=p
Q=q
RŔŖŘƦȐȒŕŗřȑȓ=r
SßŚŜŞŠƧƩȘśŝşšƨƪș=s
TŢŤŦƬƮȚţťŧƫƭț=t
UÙÚÜŨŬŮŰŲƯƱǓǕǗǙǛȔȖùúüũŭůűųưƲǔǖǘǚǜȕ=u
ÛŪû=ū
V=v
WŴŵ=w
X=x
YÝŶŸƳȲýÿŷƴȳ=y
ZŹŻŽƵƷƹƻǮȤźżžƶƸƺǯȥ=z
