.,-_ '`!?:;­´"()[]<>{}/\*«»‘’‚‛“”„‟…=
aÀÁÂÃÄÅÆĀĂǠǢǍǞǺǼȀȂȦàáâãäåæāăǡǣǎǟǻǽȁȃȧ=A
ą=Ą
bƀƁƂƃƄƅ=B
cÇĈĊČƆƇçĉċčƈ=C
ć=Ć
dĎĐƉƊƋďđƌƍ=D
eÈÉÊËĒĔĖĚƎƏƐȄȆȨèéêëēĕėěȅȇȩ=E
ę=Ę
fƑƒ=F
gĜĞĠĢƓǤǦǴĝğġģǥǧǵ=G
hĤĦǶȞĥħƕǷȟ=H
iÌÍÎÏĨĪĬĮİĲƖȈȊìíîïĩīĭįıĳƗȉȋ=I
jĴĵ=J
kĶƘǨķĸƙǩ=K
lĹĻĽĿĺļľŀƛ=L
łƚ=Ł
mƜµ=M
nÑŅŇŊƝñņňŉŋƞ=N
ń=Ń
oÒÔÕÖØŌŎŒƟƠƢǑǪǬǾȌȎȪȬȮȰòôõöøōŏœơƣǒǫǭǿȍȏȫȭȯȱ=O
őóŐ=Ó
pƤƥ=P
q=Q
rŔŖŘƦȐȒŕŗřȑȓ=R
sßŜŞŠƧƩȘŝşšƨƪș=S
ś=Ś
tŢŤŦƬƮȚţťŧƫƭț=T
uÙÚÛÜŨŪŬŮŰŲƯƱǓǕǗǙǛȔȖùúûüũūŭůűųưƲǔǖǘǚǜȕȗ=U
v=V
wŴŵ=W
x=X
yÝŶŸƳȲýÿŷƴȳ=Y
zŽƵƷƹƻǮȤžƶƸƺǯȥ=Z
ź=Ź
ż=Ż
