.,-_ '`!?:;­´"()[]<>{}/\*«»‘’‚‛“”„‟…=
aÀÁÃÄÅÆĀĄǠǢǍǞǺǼȀȂȦàáãäåæāąǡǣǎǟǻǽȁȃȧ=A
ă=Ă
â=Â
bƀƁƂƃƄƅ=B
cÇĆĈĊČƆƇçćĉċčƈ=C
dĎĐƉƊƋďđƌƍ=D
eÈÉÊËĒĔĖĘĚƎƏƐȄȆȨèéêëēĕėęěȅȇȩ=E
fƑƒ=F
gĜĞĠĢƓǤǦǴĝğġģǥǧǵ=G
hĤĦǶȞĥħƕǷȟ=H
iÌÍÏĨĪĬĮİĲƖȈȊìíïĩīĭįıĳƗȉȋ=I
î=Î
jĴĵ=J
kĶƘǨķĸƙǩ=K
lĹĻĽĿŁĺļľŀłƛƚ=L
mƜµ=M
nÑŃŅŇŊƝñńņňŉŋƞ=N
oÒÓÔÕÖØŌŎŐŒƟƠǑǪǬǾȌȎȪȬȮȰòóôõöøōŏőœơǒǫǭǿȍȏȫȭȯȱ=O
pƤƥ=P
qƢƣ=Q
rŔŖŘƦȐȒŕŗřȑȓ=R
sßŚŜŠƧƩśŝšƨƪ=S
Șşș=Ş
tŤŦƬƮťŧƫƭ=T
Țţț=Ţ
uÙÚÛÜŨŪŬŮŰŲƯƱǓǕǗǙǛȔȖùúûüũūŭůűųưƲǔǖǘǚǜȕȗ=U
v=V
wŴŵ=W
x=X
yÝŶŸƳȲýÿŷƴȳ=Y
zŹŻŽƵƷƹƻǮȤźżžƶƸƺǯȥ=Z
