.,-_ '`!?:;­"()[]<>{}/\*«»‘‚‛“”„‟…=
’´='
aÁÂÃÄÅÆĀĂĄǠǢǍǞǺǼȀȂȦáâãäåæāăąǡǣǎǟǻǽȁȃȧ=A
à=À
bƀƁƂƃƄƅ=B
cĆĈĊČƆƇćĉċčƈ=C
ç=Ç
dĎĐƉƊƋďđƌƍ=D
eËĒĔĖĘĚƎƏƐȄȆȨëēĕėęěȅȇȩ=E
è=È
é=É
ê=Ê
fƑƒ=F
gĜĞĠĢƓǤǦǴĝğġģǥǧǵ=G
hĤĦǶȞĥħƕǷȟ=H
iÍÎÏĨĪĬĮİĲƖȈȊíîïĩīĭįıĳƗȉȋ=I
ì=Ì
jĴĵ=J
kĶƘǨķĸƙǩ=K
lĹĻĽĿŁĺļľŀłƛƚ=L
mƜµ=M
nÑŃŅŇŊƝñńņňŉŋƞ=N
oÓÔÕÖØŌŎŐƟƠƢǑǪǬǾȌȎȪȬȮȰóôõöøōŏőơƣǒǫǭǿȍȏȫȭȯȱ=O
ò=Ò
œ=Œ
pƤƥ=P
q=Q
rŔŖŘƦȐȒŕŗřȑȓ=R
sßŚŜŞŠƧƩȘśŝşšƨƪș=S
tŢŤŦƬƮȚţťŧƫƭț=T
uÚÜŨŪŬŮŰŲƯƱǓǕǗǙǛȔȖúûüũūŭůűųưƲǔǖǘǚǜȕ=U
ù=Ù
ȗ=Û
v=V
wŴŵ=W
x=X
yÝŶŸƳȲýÿŷƴȳ=Y
zŹŻŽƵƷƹƻǮȤźżžƶƸƺǯȥ=Z
