.,-_ '`!?:;­´"()[]<>{}/\*«»‘’‚‛“”„‟…=
aÁÂÃÄÅÆĀĂĄǠǢǍǞǺǼȀȂȦáâãäåæāăąǡǣǎǟǻǽȁȃȧ=A
à=À
bƀƁƂƃƄƅ=B
cÇĆĈĊČƆƇçćĉċčƈ=C
dĎĐƉƊƋďđƌƍ=D
eÊËĒĔĖĘĚƎƏƐȄȆȨêëēĕėęěȅȇȩ=E
è=È
é=É
fƑƒ=F
gĜĞĠĢƓǤǦǴĝğġģǥǧǵ=G
hĤĦǶȞĥħƕǷȟ=H
iÍÎÏĨĪĬĮİĲƖȈȊíîïĩīĭįıĳƗȉȋ=I
ì=Ì
jĴĵ=J
kĶƘǨķĸƙǩ=K
lĹĻĽĿŁĺļľŀłƛƚ=L
mƜµ=M
nÑŃŅŇŊƝñńņňŉŋƞ=N
oÓÔÕÖØŌŎŐŒƟƠƢǑǪǬǾȌȎȪȬȮȰóôõöøōŏőœơƣǒǫǭǿȍȏȫȭȯȱ=O
ò=Ò
pƤƥ=P
q=Q
rŔŖŘƦȐȒŕŗřȑȓ=R
sßŚŜŞŠƧƩȘśŝşšƨƪș=S
tŢŤŦƬƮȚţťŧƫƭț=T
uÚÛÜŨŪŬŮŰŲƯƱǓǕǗǙǛȔȖúûüũūŭůűųưƲǔǖǘǚǜȕȗ=U
ù=Ù
v=V
wŴŵ=W
x=X
yÝŶŸƳȲýÿŷƴȳ=Y
zŹŻŽƵƷƹƻǮȤźżžƶƸƺǯȥ=Z
